-W------------------------
-WWW---W----W-------WWWWW-
-W---WWW----WWWWWWWWWWWWW-
-W-W-G-WWW--W--W--WWWWW---
-W----------W--W----W-----
-WWWWWWWWWWWW--WW---W---W-
-W----------W--W----W---W-
-W----------W-------W--wW-
-WWWWWWWWWW-W-------W---W-
-WWW--------W---WWW-WW--W-
------------WWWWW---------
--WWWWWWWWWWWWWW---WWWWW--
--------S-----------------
--------------------------