--------------------
----------W--W------
--------------------
------3--WWWWW------
-------------W------
--WWWWWWWWWWWWWW----
----------W---------
-----W----W----2----
----------W---------
---WWW---------W----
---S-----WW----1----
--------------------
--------------------
--------------------
--------------------